R   1000       800

NO	./pics/redbrick.xpm 
SO  ./pics/purplestone.xpm 
WE  ./pics/check.xpm 
EA  ./pics/colorstone.xpm

S ./path_to_the_sprite_texture
F         220,100,0
C 225,30,0



        1111111111111111111111111
        1100000000110000000000011
        111100000000000E000000011
        1111000001110000000000011
		1111111111111111111111111