R   1000       800

NO	./pics/redbrick.xpm 
SO  ./pics/purplestone.xpm 
WE  ./pics/check.xpm 
EA  ./pics/colorstone.xpm

S ./pics/icecream.xpm
F         220,100,0
C 225,30,0



        1111111111111111111111111
        1100000000111111111000001
        111100000000000E000000011
        1111000001111111111110001
        1111111111111111111111111
