R   1234       1600
#4294967994
NO ./pics/size1.xpm 
SO  ./pics/devo4ka.xpm 
WE  ./pics/kitty.xpm 
EA  ./pics/pesok.xpm

S ./pics/barrel.xpm
F         220,100,0
C 225,30,0



        1111111111111111111111111
        1000000000110002000000001
        1011000001110000002000001
        1001000000000000000000001
111111111011000001110000000000001
100000000011000001110111110111111
11110111111111011100000010001
11110111111111011101010010001
11220000110101011100000010001
10000000000000001100000010001
10200000000000001101010010001
11020001110101011111011110N0111
11110111 1110101 101111010001
11110111 1111111 111111111111
11110111111111111111111111111
10000000001100000000000000001
10110000011100000000000010001
10010000000000000000000010001
10110000011100000000000010001
10000000001100000111011110001
11110111111111011100000010001
11110111111111011001010010001
11000000110101011000000010001
10000000000000001000000010001
10000000000000001000010000001
11000000110101000000000000001
11110111110101000000100000001
10000000001100000100000110001
10000000000000000000000111001
10000000001000010000000111001
10000000001101000000000100001111111111111111111111111111111111111111111111111111111111111111111
10000000000100000001000000000000000000000000000000000000000000000000000000000000000000000000001
11111111111111111111111111111111111111111111111111111111111111111111111111111111111111111111111
