R   1600     1200
NO          ./pics/size1.xpm 
SO  ./pics/doggy.xpm 
WE  ./pics/kitty.xpm 
EA  ./pics/pesok.xpm

S  ./pics/icecream.xpm  
F       160,160,160
C    210,255,255


        1111111111111111111111111
        1000000000110002000000001
        1011000001110000000002001
        1001000000000000000000001
111111111011000001110000000000001
100000000011000001110111110111111
11110111111111011100000010001
11110111111111011101010010001
11220000110101011100000010001
10000000000000001100000010N01
10200000000000001101010010001
1100000111010101111101111000111
11110111 1110101 101111010001
11110111 1111111 111111111111
1111011111111111111111111111111111111111111111111111111111
1000000000110000000000000000110000000001100000000000000001
10110000000000000000000010000001000000000000000000001000 1
1011000000000000000000001000110000000001100000111011110001
1011000001110000000000001000110010000000000000000000010001
1011000001110000000000001000111111111111111111111111111111
10000000001100000111011110001
11110111111111011100000010001
11110111111111011001010010001
11000000110101011000000010001
10000000000000001000000010001
10000000000000001000010000001
11000000110101000000000000001
11110111110101000000100000001
10000000001100000100000 10001
10000000000000000000000 11001
10000000001000010000000 11001
10000000001101000000000 00001111111111111111111111111111111111111111111111111111111111111111111111
10000000000 00000001000000000000000000000000000000000000000000000000000000000000000000000000000001
11111111111111111111111111111111111111111111111111111111111111111111111111111111111111111111100001
                                                                                            100001
                                                                                            100001
                                                                                            120021
                                                                                            120021
                                                                                            120021
                                                                                            120021
                                                                                            120021
                                                                                            120021
                                                                                            120021
                                                                                            120021
                                                                                            120021
                                                                                            120021
                                                                                            120021
                                                                                            120021
                                                                                            120021
                                                                                            120021
                                                                                            122021
                                                                                            111111
